0000000000000000000000000000000000000000000
0777788888000000080000220000000077700007770
0700000000000088880000220000000000000000070
0700000333000088880000220000000000000000070
0700033303000088880000226600000333333000070
0700335003000088880006220063333333333300070
0700305003000888880660220000633000003000000
0000305005000888886000220055553600003000000
0700005003008088880555220000053366003000000
0700305000308088880555220000005300636666660
0800305000308088880555220000005030030000000
0803005000008088880555220000005030300000000
0803005000308088880555220000005033300000070
0883888888388888888888228888888888888888077
0883888888888888888888228888222222222222007
0803000000360088880555220000222222222222007
0888000000360088880555220000222222222222007
0808000000300088880003220000222222222222007
0883000003300088880003220000222222222222077
0883000033300088880330220000262226222222070
0003000033300088883000220005222222226222070
0003000033308088883000220050222622222222070
0000008833008888880000220553222222222222070
0000008830000888880000225003222662222222070
0000008800000888880000225030262222222222077
0000008800008088880000223030222222226222077
0700000080888088880000223300262222222222077
0770000088000088880000223300222222222222070
0770000000000088880000220000222222222222770
0000000000000000000000000000000000000000000
0000000000000000000000000000000000000000000
0000000000000000000000000000000000000000000
0000000000000000000000000000000000000000000
