0000000000000000000000000000000000000000000
0000000000000000000000000000000000000333000
0000000000000000000000000000000000003300000
0000000000000000033333333000000333333000000
0000000000000033300000000333033003003000000
0000000000003330000000500003330030003000000
0000000000033000000000500003033300003000000
0000000000330000000555500030003330003000000
0000000003300000000505550030003030003000000
0000000003000000000505550300003033003000000
0000000003000000000505555300030003030000000
0000000003000000000500005030030003030000003
0000000000000000000500505030030003300000003
0000000000000000000550550033030003300000030
0000000000000000055555555503033333000000030
0000000000000555550000555000330003000000300
0000000000055500000000550000003333000000300
0000000000500000000000500000000000000003300
0000000000000000000000000000000000000003000
0000000000000000000000000000000000000030000
0000000000000000000000000000000000000330000
0000007700000000000000000000000000700330000
0000007777777777777777777777777777700033000
0000000077777777777777777777000000000000000
0000000000000000000000000000000000000000000
0000000000000000000000000000000000000000000
0000000000000000000000000000000000000000000
0000000000000000000000000000000000000000000
0000000000000000000000000000000000000000000
