0000000000000000000000000000000000000000000
0000000000000000088000000000000003000000000
0000000000000000888000000000000003000000000
0000000000000008884000000000000003000000000
0000000000000008884000000004400003000300000
0000000000000008804000000004000003003330000
0000000000000088884000000047000003003030000
0000000040002288084000470047000003033030000
0000000022228880884444400470000003030030000
0000002200888088884000000000000003030030000
0000220008800088804000000000000003030000000
0002200088000088024000044407744403030000000
0002000080000000024040444077774403030030000
0002000000000004042004444770074008330030000
0002000000044400004004407700070008330030000
0002000000000000004040477008870008330030000
0002000000000000004440774058870008330030000
0002000000000000888888744788870083030030000
0002000000000000000008888880870083030030000
0002000500000000000000774700870803030300000
0002000555000000000000774000800803030300000
0002000005550000000000470000808003033300000
0002000000005555005550470000888003033000000
0002000000000005550000070008800033033000000
0002000000000000000000000008800000000000000
0000000000000000000000000000000000000000000
0000000000000000000000000000000000000000000
0000000000000000000000000000000000000000000
0000000000000000000000000000000000000000000
0000000000000000000000000000000000000000000
0000000000000000000000000000000000000000000
0000000000000000000000000000000000000000000
0000000000000000000000000000000000000000000
